1111111111111111111111111111111111
100000000000000C00000C000000000001
1110011110011110101111111111111101
1110111111111111110011001111111101
111000000C00C0001111110000000000C1
111100000000000000000000000C000001
1011111111111111111000000000000001
100000000000000C00000C000000000001
1110011110011110100111011111111101
1110011111111110111111001111111101
100000000C00C0001111110000000000C1
1000000000000000000000011000000001
100001111111100000C000000111100001
1E10111110000000C00000C00000000001
1110011110011110101111011111111101
1C10011111111110111111001111111101
1P0000000C00C0001111110000000000C1
1111111111111111111111111111111111