11111111111111111111111111111111111111111111111111111111111111111111
100000000000000C00000C000000000000000000000000000C00000C000000000001
11100111100111101011111111111111000110011110011110101111111111111101
11101111111111111100110011111111000110111111111111110011001111111101
111000000C00C0001111110000000000C0011000000C00C0001111110000000000C1
111100000000000000000000000C000000011100000011111100000000000C000001
1011111111111111111000000000011110001111111111111111100000X000000001
100000000000000C00000C000000000000000000000000000C00000C000000000001
11100111100111101001110111111111000110011110011110100111011111111101
11100111111111101111110011111111000110011111111110111111001111111101
100000000C00C0001111110000000000C0000000000C00C0001111110000000000C1
100000000000000000000001100000000000000000000000000X0000011000000001
100001111111100X00C000000111100001111111111111100000C000000111100001
1E10111110000000C00000C000000000000E10111110000000C00000C00000000001
11100111100111101011110111111111000110011111111110101111011111111101
1C100111111111101111110011111111000C10011111111110111111001111111101
1P0000000C00C0001111110000000000C0010000000C00C0001111110000000000C1
11111111111111111111111111111111111111111111111111111111111111111111